111010010010000001111100111101001011001101100010001101
011010110000111011000111101100000000100000010001000010
010010010010001100000000100000010100000100010001011000
001111101010100100101101001100110101010110001001000011
000000001010110001000110011000000000110000011010110111
110100000011101011000010010010101111010000001001001001
101101100001000001101000001000100100010110111011000000
101101110010001011000010101100000111010011100001100001
000000111010110110110101001000101000010001010111100111